[
  {
    "grid": [
      "1111111111111111111111111111111111",
      "1111111111111111111111111111111111",
      "1111111111111111111111111111111111",
      "1000000000000000000000000000000001",
      "1000000000000000000000000000000001",
      "1000000000000000000000000000000001",
      "1000000000000000000000000000000001",
      "1000000000000000000000000000000001",
      "1000000000000000000000000000000001",
      "1000000000000000000000000000000001",
      "1111111111111111111111111110000001",
      "1111111111111111111111111110000001",
      "1111111111111111111111111112222221",
      "1111111111111111111111111112222221",
      "1111111111111111111111111112222221",
      "1111111111111111111111111111111111",
      "1111111111111111111111111111111111",
      "1111111111111111111111111111111111"
    ],
    "startx": 3,
    "starty": 6,
    "campfire": [
      {"x": 3, "y": 6},
      {"x": 30, "y": 6}
    ]
  },
  {
    "grid": [
      "11111111111111111111111111111111111111111111111111",
      "10000000011111111000000000000000000000000000000001",
      "10000000011111111000000000000000000000000000000001",
      "10000000011111111000000000000000000000000000000001",
      "10000000011111111000000000000000000000000000000001",
      "10000000011111111000000000000000000000000000000001",
      "10000000011111111000000000000000000000000000000001",
      "10000000011111111000000000000000000000000000000001",
      "10000000011111111000000011111111111111111111000001",
      "10000000011111111000000011111111111111111111000001",
      "10000000011111111000000011000000000000022221000001",
      "10000000011111111000000011000000000000022221000001",
      "10000000000000000000000011000000000000022221000001",
      "10000000000000000000000011000000000000022221000001",
      "10000000000000000000000011000000111111111111000001",
      "10000000000000000000000011000000000000000000000001",
      "10000000000000000000000011000000000000000000000001",
      "10000000000000000000000011000000000000000000000001",
      "10000000000000000000000011000000000000000000000001",
      "11111111111111111111111111111111111111111111111111"
    ],
    "startx": 2,
    "starty": 2,
    "campfire": [
      {"x": 12, "y": 16},
      {"x": 40, "y": 5}
    ]
  },
  {
    "grid": [
      "11111111111111111111111111111111111111111111111111",
      "10000000000010000000000000000000100000000000000001",
      "10000000000010000000000000000000100000000000000001",
      "10000000000010000000000000000000100000000000000001",
      "10000000000010000111111111110000100011111111110001",
      "11111111000010000100000000000000100010000000000001",
      "10000000000010000100000000000000100010000000000001",
      "10000000000010000100000000000000100010000000000001",
      "10000000000010000100011111110000100010000111111111",
      "10000000000010000100011111110000100010000000000001",
      "10000111111110000100000000010000100010000000000001",
      "10000000000000000100000000010001110011111111110001",
      "10000000000000000100000000010000000010000000010001",
      "10000000000000000100011100010000000010000000010001",
      "10000000000000000100011100010000000010011111010001",
      "10000111111111111100011100011111111110010000010001",
      "10000000000000000000011100000000000000010011110001",
      "10000000000000000000011100000000000000010000002221",
      "10000000000000000000011100000000000000010000002221",
      "11111111111111111111111111111111111111111111111111"
    ],
    "startx": 2,
    "starty": 2,
    "campfire": [
      {"x": 4, "y": 15},
      {"x": 32, "y": 13},
      {"x": 47, "y": 2},
      {"x": 24, "y": 11},
      {"x": 42, "y": 15}
    ]
  },
  {
    "grid": [
      "11111111111111111111111111111111111111111111111111",
      "10000000000011000000000000000000110000000000000001",
      "10000000000001100000000000000000110000000000000001",
      "10000000000000110000000000000000110000000000000001",
      "11111111000000011111111111110000110000111111110001",
      "11111111000000000000000000000000110000100000010001",
      "11111111000000000000000000000000110000100000010001",
      "11111111000000111111111111111111110000100012210001",
      "11111111000000111111111111111111110000100011110001",
      "10000000000000111111100011110000000000100000000001",
      "10000000000000111111000001110000000000100000000001",
      "10000111111111111110000000110000000000100000000001",
      "10000111111111111100001000010000111111111111111111",
      "10000000000000000000011100000000111111111111111111",
      "10000000000000000000111110000000111111111111111111",
      "11111111111111111111111111111111111111111111111111"
    ],
    "startx": 17,
    "starty": 2,
    "campfire": [
      {"x": 2, "y": 2},
      {"x": 35, "y": 10}
    ]
  },
  {
    "grid": [
      "11111111111111111111111111111111111111111111111111",
      "10000000000000000000000000000000000000000000000001",
      "10000000000000011000001100000000000000000000011001",
      "10000000110000011000001100000000001100001100011001",
      "10000000110000000000000000110000001100001100000001",
      "10000000000011000000000000110000000000000000000001",
      "10001100000011000001100000000000000000000011000001",
      "10001100000000000001100000000001100000000011000001",
      "10000000000000000000000011000001100000110000000001",
      "10000000001100001100000011000000000110110000000001",
      "10000000001100001100000000000000000110000000001101",
      "10000000000000000000110000000000000000000000001101",
      "10000110000000000000110000001100011000000000000001",
      "10000110000000000000000000001100011000000000110001",
      "10000000001100000000000000000000000000110000110001",
      "10000000001100000000001100000001100110110110000001",
      "10000011000000000000001100000001100110000110000001",
      "10000011000000000000000000001100000000000000110001",
      "10000000000000110000001100001100000022222000110001",
      "10000000000000110000001100000000000022222000000001",
      "10000110000000000000000000000110110000000000000001",
      "10000110000000000001100000000110110001100001100001",
      "10000000000110000001100000110000000001100001100001",
      "10000000000110000000000000110000000000000000000001",
      "10000000000000000000000000000000000000000000000001",
      "11111111111111111111111111111111111111111111111111"
    ],
    "startx": 25,
    "starty": 13,
    "campfire": [
      {"x": 25, "y": 13}
    ]
  }
]
